TTTTTTTTTTTTTTTTTTTT
T T        T       T
T T TTTT TTT TTTTTTT
T T T              T
T T T TTTTT TTT T TT
T TTT T   T T T T TT
I     T   T T TTTTTT
T TTTTT T T        T
T T     T   T   TT O
TTTTTTTTTTTTTTTTTTTT