TTTTTTTTTTTTTTTITTT
T                 T
T TTTTTTTTTTTTTTTTT
T             T   T
T TTT TTTTT T T T T
T   T T   T T T T T
T T T TTT T T T T T
T T T     T T   T T
TTTTTTTTTTTOTTTTTTT